0000000000000000000000000000000000000000
0000000000000000000000000000000000000000
0000000000000000000000000000000000000000
0000000000000000000000000000000000000000
0000000000000000000000000000000000000000
0000000000000000000000000000000000000000
0000000000000000000000000000000000000000
0000000000000000000000000000000000000000
0000000000000000000000000000000000000000
0000000000000000000000000000000000000000
0000000000999999999999999999990000000000
0000000000999999999999999999990000000000
0000000000999999999999999999990000000000
0000000000999999999999999999990000000000
0000000000999999999999999999990000000000
0000000000000000000040000000000000000000
0000000000999999999999999999990000000000
0000000000999999999999999999990000000000
0000000000999900999999999999990000000000
0000000000999911999999999999990000000000
0000000000999922999999999999990000000000
0000000000999933999999999999990000000000
0000000000999944999999999999990000000000
0000000000999955999999999999990000000000
0000000000999966999999999999990000000000
0000000000999977999999999999990000000000
0000000000999988999999999999990000000000
0000000000999999999999999999990000000000
0000000000999999999999999999990000000000
0000000000999999999999999999990000000000
0000000000000000000000000000000000000000
0000000000000000000000000000000000000000
0000000000000000000000000000000000000000
0000000000000000000000000000000000000000
0000000000000000000000000000000000000000
0000000000000000000000000000000000000000
0000000000000000000000000000000000000000
0000000000000000000000000000000000000000
0000000000000000000000000000000000000000
0000000000000000000000000000000000000000