0000000000000000000000000000000000000000
0000000000000000000000000000000000000000
0000000000000000000000000000000000000000
0000000000000000000000000000000000000000
0000000000000000000000000000000000000000
0000000000000000000000000000000000000000
0000000000000000000000000000000000000000
0000000000000000000000000000000000000000
0000000011111111111111111111111100000000
0000000012222222222222222222222100000000
0000000012333333333333333333332100000000
0000000012344444444444444444432100000000
0000000012345555555555555555432100000000
0000000012345666666666666665432100000000
0000000012345677777777777765432100000000
0000000012345670000000000765432100000000
0000000012345670000000000765432100000000
0000000012345670000000000765432100000000
0000000012345670000000000765432100000000
0000000012345670000000000765432100000000
0000000012345670000000000765432100000000
0000000012345670000000000765432100000000
0000000012345670000000000765432100000000
0000000012345670000000000765432100000000
0000000012345670000000000765432100000000
0000000012345677777777777765432100000000
0000000012345666666666666665432100000000
0000000012345555555555555555432100000000
0000000012344444444444444444432100000000
0000000012333333333333333333332100000000
0000000012222222222222222222222100000000
0000000011111111111441111111111100000000
0000000000000000000000000000000000000000
0000000000000000000000000000000000000000
0000000000000000000000000000000000000000
0000000000000000000000000000000000000000
0000000000000000000000000000000000000000
0000000000000000000000000000000000000000
0000000000000000000000000000000000000000
0000000000000000000000000000000000000000