AAAAAAAAAAAAAAAAAAAAAAAAAAAAAAAAAAAAAAAA
A00000000000000000000000000000000000000A
A00000000000005111111115000000000000000A
A00000000000004111111111000000000000000A
A00000000000003111111111000000000000000A
A00000000000002111111111000000000000000A
A00000000000001511111115000000000000000A
A00000000000000000000000000000000000000A
A00000000000000000000000000000000000000A
A00000000000000000000000000000000000000A
A00000000000000000000000000000000000000A
A00000000000000000000000000000000000000A
A00000000000000000000000000000000000000A
A00000000000000000000000000000000000000A
A00000000000000044444444444000000000000A
A00000000000000040000000004000000000000A
A00000000000000040000000004000000000000A
A00000000000000040000000004000000000000A
A00000000000000040005550004000000000000A
A00000000000000040005550004000000000000A
A00000000000000040005550004000000000000A
A00000000000000040005550004000000000000A
A00000000000000040005550004000000000000A
A00000000000000040005550004000000000000A
A00000000000000040005550004000000000000A
A00000000000000040005550004000000000000A
A00000000000000040000000004000000000000A
A00000000000000040000000004000000000000A
A00000000000000040000000004000000000000A
A00000000000000044444444444000000000000A
A00000000000000000000000000000000000000A
A00000000000000000000000000000000000000A
A00000000000000000000000000000000000000A
A00000000000000000000000000000000000000A
A00000000000000000000000000000000000000A
A00000000000000000000000000000000000000A
A00000000000000000000000000000000000000A
A00000000000000000000000000000000000000A
A00000000000000000000000000000000000000A
AAAAAAAAAAAAAAAAAAAAAAAAAAAAAAAAAAAAAAAA