AAAAAAAAAAAAAAAAAAAAAAAAAAAAAAAAAAAAAAAA
A00000000000000000000000000000000000000A
A00000000000000000000000000000000000000A
A00000000000000000000000000000000000000A
A00000000000000000000000000000000000000A
A00000000000000000000000000000000000000A
A00000000000000000000000000000000000000A
A00000000000000000000000000000000000000A
A00000000000000000000000000000000000000A
A00000000CAACAACAACAACAACAACAAC00000000A
A00000000A11111111111111111111A00000000A
A00000000A11111111111111111111A00000000A
A00000000C11111111111111111111C00000000A
A00000000A11111111111111111111A00000000A
A00000000A11111111111111111111A00000000A
A00000000CAAAAAAAAAA6AAAAAAAAAA00000000A
A00000000A11111111111111111111A00000000A
A00000000A11111111111111111111A00000000A
A00000000C11111111111111111111C00000000A
A00000000A11111111111111111111A00000000A
A00000000A11111111111111111111A00000000A
A00000000C11111111111111111111C00000000A
A00000000A11111111111111111111A00000000A
A00000000A11111111111111111111A00000000A
A00000000C11111111111111111111C00000000A
A00000000A11111111111111111111A00000000A
A00000000A11111111111111111111A00000000A
A00000000C11111111111111111111C00000000A
A00000000A11111111111111111111A00000000A
A00000000A11111111111111111111A00000000A
A00000000CAACAACAACAACAACAACAAC00000000A
A00000000000000000000000000000000000000A
A00000000000000000000000000000000000000A
A00000000000000000000000000000000000000A
A00000000000000000000000000000000000000A
A00000000000000000000000000000000000000A
A00000000000000000000000000000000000000A
A00000000000000000000000000000000000000A
A00000000000000000000000000000000000000A
AAAAAAAAAAAAAAAAAAAAAAAAAAAAAAAAAAAAAAAA