0000000000000000000000000000000000000000
0000111111100000000000011111111110000000
0001111111111000000001100000000011000000
0000011111100000000001100011100001100000
0000111111110000000001100011100000000000
0000000000000000000000110000001100000000
0000000000000000000000001111111000000000
0000000000000000000000000000000000000000
0000000000000000000000000000000000000000
0000000000000000000000000000000000000000
0000000000000000000000000001111110000000
0000000000000000000000000111111100000000
0000000000000000000000000011111111000000
0000000000000000000000000000111111100000
0000000000000000000000000000000000000000
0000000000000000000000000000000000000000
0000111111111110000000000000000000000000
0001111111111111110000000000000000000000
0011111111100000000000000000000000000000
0000000122111111111110000000000000000000
0000000011111111111100000000000000000000
0000000000111110000000000000000000000000
0000000000000000000000000000000111100000
0000000000000000000000000000001111110000
0000000000000000000000000000000111111000
0000000000000000000000000000000011100000
0000000000000000000000000000000000000000
0000000000000000000000000000000000000000
0000000000000000000000000000000000000000
0000000000000001111111111111111111100000
0000000000000111111111111111100000000000
0000000000000000011111111111111110000000
0000011111111111111111000000000000000000
0000000000000000111111111111100000000000
0000000000000011100000000001110000000000
0000000000000111000000000011100000000000
0000000000000011100000000111110000000000
0000000000000111110000000011111000000000
0000000000011111100000000000011100000000
0000000000000000000000000000000000000000