AAAAAAAAAAAAAAAAAAAAAAAAAAAAAAAAAAAAAAAA
A00000000000000000000000000000000000000A
A00000000000000000000000000000000000000A
A00000000000000000000000000000000000000A
A00000000000000000000000000000000000000A
A00000000000000000000000000000000000000A
A00000000000000000000000000000000000000A
A00000000000000000000000000000000000000A
A00000000000000000000000000000000000000A
A0000000000AA22222222222222AA0000000000A
A0000000000AA22222222222222AA0000000000A
A00000000000000000000000000000000000000A
A00000000000000000000000000000000000000A
A00000AA000000000000000000000000AA00000A
A00000AA000000000000000000000000AA00000A
A00000220000000000000000000000002200000A
A00000220000000000000000000000002200000A
A00000220000000000000000000000002200000A
A00000AA000000000000000000000000AA00000A
A00000AA000000000000000000000000AA00000A
A00000220000000000000000000000002200000A
A00000220000000000000000000000002200000A
A00000220000000000000000000000002200000A
A00000220000000000000000000000002200000A
A00000AA000000000000000000000000AA00000A
A00000AA000000000000000000000000AA00000A
A00000000000000000000000000000000000000A
A00000000000000000000000000000000000000A
A0000000000AA22222222222222AA0000000000A
A0000000000AA22222222222222AA0000000000A
A00000000000000000000000000000000000000A
A00000000000000000000000000000000000000A
A00000000000000000000000000000000000000A
A00000000000000000000000000000000000000A
A00000000000000000000000000000000000000A
A00000000000000000000000000000000000000A
A00000000000000000000000000000000000000A
A00000000000000000000000000000000000000A
A00000000000000000000000000000000000000A
AAAAAAAAAAAAAAAAAAAAAAAAAAAAAAAAAAAAAAAA