AAAAAAAAAAAAAAAAAAAAAAAAAAAAAAAAAAAAAAAA
A00000000000000000000000000000000000000A
A00000000000000000000000000000000000000A
A00000000000000000000000000000000000000A
A00000000000000000000000000000000000000A
A00000000000000000000000000000000000000A
A00000000000000000000000000000000000000A
A00000000000000000000000000000000000000A
A00000000000000000000000000000000000000A
A00000000000000000000000000000000000000A
A00000000000000000000000000000000000000A
A00000000000000000000000000000000000000A
A00000000000000000000000000000000000000A
A00000000000000000000000000000000000000A
A00000000000000000000000000000000000000A
A00000000000000000000000000000000000000A
A00000000000000000000000000000000000000A
A0000000000000FFFFFFFF00000000000000000A
A0000000000000F000000F00000000000000000A
A0000000000000F000000F00000000000000000A
A0000000000000F000000F00000000000000000A
A0000000000000F000000F00000000000000000A
A0000000000000F000000F00000000000000000A
A0000000000000F000000F00000000000000000A
A0000000000000F000100F00000000000000000A
A0000000000000F001200F00000000000000000A
A0000000000000F022320F00000000000000000A
A0000000000000FAAA4AAF00000000000000000A
A0000000000000FAA44AAF00000000000000000A
A00000000000000333333000000000000000000A
A00000000000000022220000000000000000000A
A00000000000000001100000000000000000000A
A00000000000000000000000000000000000000A
A00000000000000000000000000000000000000A
A00000000000000000000000000000000000000A
A00000000000000000000000000000000000000A
A00000000000000000000000000000000000000A
A00000000000000000000000000000000000000A
A00000000000000000000000000000000000000A
AAAAAAAAAAAAAAAAAAAAAAAAAAAAAAAAAAAAAAAA