AAAAAAAAAAAAAAAAAAAAAAAAAAAAAAAAAAAAAAAA
A00000000000000000000000000000000000000A
A00000000000000000000000000000000000000A
A00000000000000000000000000000000000000A
A00000000000000000000000000000000000000A
A00001111111112111111111121111111110000A
A00001222222223222222222232222222210000A
A00001233333334333333333343333333210000A
A00001233333334333333333343333333210000A
A00001233333334333333333343333333210000A
A00001233333334333333333343333333210000A
A00001233333334333333333343333333210000A
A00001233333334333333333343333333210000A
A00001233333334333333333343333333210000A
A00002344444444333333333344444444320000A
A00001233333333000000000033333333210000A
A00001233333333000000000033333333210000A
A00001233333333000000000033333333210000A
A00001233333333000000000033333333210000A
A00001233333333000000000033333333210000A
A00001233333333000000000033333333210000A
A00001233333333000000000033333333210000A
A00001233333333000000000033333333210000A
A00001233333333000000000033333333210000A
A00001233333334000000000043333333210000A
A00002344444444333333333344444444320000A
A00001233333334333333333343333333210000A
A00001233333334333333333343333333210000A
A00001233333334333333333343333333210000A
A00001233333334333333333343333333210000A
A00001233333334333333333343333333210000A
A00001233333334333311333343333333210000A
A00001233333334333300333343333333210000A
A00001222222223222200222232222222210000A
A00001111111112111100111121111111110000A
A00000000000000000000000000000000000000A
A00000000000000000000000000000000000000A
A00000000000000000000000000000000000000A
A00000000000000000000000000000000000000A
AAAAAAAAAAAAAAAAAAAAAAAAAAAAAAAAAAAAAAAA