AAAAAAAAAAAAAAAAAAAAAAAAAAAAAAAAAAAAAAAA
A00000000000000000000000000000000000000A
A00000000000000000000000000000000000000A
A00000000000000000000000000000000000000A
A00000000000000000000000000000000000000A
A00000000000000000000000000000000000000A
A00000000000000000000000000000000000000A
A00000000000000000000000000000000000000A
A00000000000000000000000000000000000000A
A00000000088888888888888888888000000000A
A00000000088888888888888888888000000000A
A00000000088888888888888888888000000000A
A00000000088888888888888888888000000000A
A00000000088888888888888888888000000000A
A00000000088888888888888888888000000000A
A00000000088888888888888888888000000000A
A00000000088888888888888888888000000000A
A00000000088888888888888888888000000000A
A00000000088888888888888888888000000000A
A00000000088888888888888888888000000000A
A00000000088888888888888888888000000000A
A00000000088888888888888888888000000000A
A00000000088888888888888888888000000000A
A00000000088888888888888888888000000000A
A00000000088888888888888888888000000000A
A00000000088888888888888888888000000000A
A00000000088888888888888888888000000000A
A00000000088888888888888888888000000000A
A00000000088888888888888888888000000000A
A00000000000000000000000000000000000000A
A00000000000000000000000000000000000000A
A00000000000000000000000000000000000000A
A00000000000000000000000000000000000000A
A00000000000000000000000000000000000000A
A00000000000000000000000000000000000000A
A00000000000000000000000000000000000000A
A00000000000000000000000000000000000000A
A00000000000000000000000000000000000000A
A00000000000000000000000000000000000000A
AAAAAAAAAAAAAAAAAAAAAAAAAAAAAAAAAAAAAAAA