AAAAAAAAAAAAAAAAAAAAAAAAAAAAAAAAAAAAAAAA
A00000000000000000000000000000000000000A
A00000000000000000000000000000000000000A
A00000000000000000000000000000000000000A
A00000000000000000000000000000000000000A
A00000000000000000000000000000000000000A
A00000000000000000000000000000000000000A
A00000000000000000000000000000000000000A
A00000000000000000000000000000000000000A
A00000000000000000000000000000000000000A
A00000000000000000000000000000000000000A
A00000000000000000000000000000000000000A
A00000000000000000000000000000000000000A
A00000000000000000000000000000000000000A
A00000000000000000000000000000000000000A
A00000000000000000000000000000000000000A
A00000000000000000000000000000000000000A
A00000000000000000000000000000000000000A
A00000000000000000000000000000000000000A
A00000000000000000000000000000000000000A
A00000000000000000000000000000000000000A
A00000000000000000000000000000000000000A
A00000000000000000000000000000000000000A
A00000000000000000000000000000000000000A
A00000000000000000000000000000000000000A
A00000000000000000000000000000000000000A
A00000000000000000000000000000000000000A
A00000000000000004444444444400000000000A
A00000000000000004333333333400000000000A
A00000000000000004333333333400000000000A
A00000000000000004333333333400000000000A
A00000000000000004444444444400000000000A
A00000000000000000000000000000000000000A
A00000000000000000000000000000000000000A
A00000000000000000000000000000000000000A
A00000000000000000000000000000000000000A
A00000000000000000000000000000000000000A
A00000000000000000000000000000000000000A
A00000000000000000000000000000000000000A
AAAAAAAAAAAAAAAAAAAAAAAAAAAAAAAAAAAAAAAA