AAAAAAAAAAAAAAAAAAAAAAAAAAAAAAAAAAAAAAAA
A00000000000000000000000000000000000000A
A00000000000000000000000000000000000000A
A00000000000000000000000000000000000000A
A00000000000AAAAAAAAAAAAAAA000000000000A
A00000000000A0000000000000A000000000000A
A00000000000A0000000000000A000000000000A
A00000000000A0000000000000A000000000000A
A00000000000000000000000000000000000000A
A0000A0000000000000000000000000000A0000A
A0000A0000000000000000000000000000A0000A
A0000A0000000000000000000000000000A0000A
A0000A0000000000000000000000000000A0000A
A0000A000000000AAAAAAAA00000000000A0000A
A0000A0000000000000000000000000000A0000A
A00000000AAAAAA00000000AAAAAAAA00000000A
A00000000A00000000000000000000A00000000A
A00000000A00000000000000000000A00000000A
A00000000A00000AAAAAAAA0000000A00000000A
A00000000A00000000000000000000A00000000A
A00000000A00000000000000000000A00000000A
A00000000A00000000000000000000A00000000A
A00000000A00000000000000000000A00000000A
A00000000A00000000000000000000A00000000A
A00000000A00000000000000000000A00000000A
A00000000A00000000000000000000A00000000A
A00000000AAAAAAAAAAAAAAAAAAAAAA00000000A
A00000000000000000000000000000000000000A
A00000000000000000000000000000000000000A
A000A0000000000000000000000000000000000A
A000A0000000000000000000000000000000000A
A000A000AAAAA000AAAAAAAA0000AAAA0000000A
A000A000A0000000000000000000000A0000000A
A000A000A0000000000000000000000A0000000A
A000A000A0000000000000000000000A0000000A
A000A000A000AAAAAAAAAAAAAAAA000A0000000A
A00000000000000000000000000000000000000A
A00000000000000000000000000000000000000A
A00000000000000000000000000000000000000A
AAAAAAAAAAAAAAAAAAAAAAAAAAAAAAAAAAAAAAAA